1111111111111
10010000000C1
1111111111111
11P0011E000001
